111111
1P0011
100001
1C00E1
100001
111111