1111111111111111111111111111111111
1E0000000000001C00000C000000000011
1110010100100010101001000000010101
1010010010101110001001000000010101
1P0000000C01C0000000000000000000C1
1111111111111111111111111111111111
